#######
# b  D#
# b b #
# b b #
#P## D#
#######
