#####
#b D#
#bb #
#Pb #
#####
