###########
#         #
#         #
#         #
#         #
###########
##D####Plb#
###########
